111111111111111111111111111111111
10000C110000000C111100000000000E1
1101001C0011000011111011000000001
10011C1111C0000011111011100111111
1001100000000101111000C1100C00001
1001110000C1100111001111100101001
1P000000111C000000000000100C00001
111111111111111111111111111111111
