1111111
1P0C0E1
1000001
1000101
1000001
10000C1
1111111