111111111111111111111111111111111111111
100000000000000000000000000000000000001
100011111111000000000000000000000000001
100000000001000000000000000000C00000001
100000000001000000000000000000000000001
111111111101000000000000000000000000001
100000000001000000000000000000000000001
100000000001000000000000000000000000001
100011111111000000000000000000000000001
100000000000000000000000000000000000001
100011111111111111111111111111100000001
100000000000000000000000000000100000001
111111111111111110000111111111100000001
100000000000000001000000000000100000001
100000000000000001000000000000100000001
100000000000000001000000000000100000001
111111111111111111111111101111111111111
100000000000000000000000000000000000001
100011111111000000000000000000000000001
100000000001000000000000000000000000001
100000000001000000000000000000000000001
111111111101000000000000000000000000001
100000000001000000000000000000000000001
100000000001000000000000000000C00000001
100011111111000000000000000000000000001
100000000000000000000000000000000000001
100011111111111111111111111111100000001
10000000000000000000000000000P100000E01
111111111111111111111111111111111111111